 ಹೊಸದಿಲ್ಲಿ:	UNK	 ಹೊಸದಿಲ್ಲಿ:.
ದಿಢೀರ್‌	UNK	ದಿಢೀರ್‌.
ಬೆಳವಣಿಗೆಯೊಂದರಲ್ಲಿ ಶಶಾಂಕ್‌	UNK	ಬೆಳವಣಿಗೆಯೊಂದರಲ್ಲಿ ಶಶಾಂಕ್‌.
ಮನೋಹರ್‌	UNK	ಮನೋಹರ್‌.
ಅವರು	PRP.n.f.pl.3.d	ಅವಳು.0
ಅಂತರಾಷ್ಟ್ರೀಯ	NN.unk....	ಅಂತರಾಷ್ಟ್ರೀಯ.
ಕ್ರಿಕೆ‌ಟ್‌	UNK	ಕ್ರಿಕೆ‌ಟ್‌.
ಸಮಿತಿಯ	NN.n.n.sg..o	ಸಮಿತಿ.ಅ
ಮುಖ್ಯಸ್ಥ	NN.n.m.sg.3.d	ಮುಖ್ಯಸ್ಥ.0
ಸ್ಥಾನಕ್ಕೆ	NN.n.n.sg..o	ಸ್ಥಾನ.ಇಗೆ
ಬುಧವಾರ	NNP.n.n.sg..d	ಬುಧವಾರ.0
ರಾಜೀನಾಮೆ	NN.n.n.sg..d	ರಾಜೀನಾಮೆ.0
ನೀಡಿದ್ದಾರೆ.	UNK	ನೀಡಿದ್ದಾರೆ..
.	SYM.punc....	..


ವೈಯ್ಯಕ್ತಿಕ	JJ.unk....	ವೈಯ್ಯಕ್ತಿಕ.
ಕಾರಣಗಳಿಂದ	NN.n.n.pl..o	ಕಾರಣ.ಇಂದ
ಉನ್ನತ	JJ.avy....	ಉನ್ನತ.
ಹುದ್ದೆಗೆ	NN.n.n.sg..o	ಹುದ್ದೆ.ಇಗೆ
ರಾಜೀನಾಮೆ	NN.n.n.sg..d	ರಾಜೀನಾಮೆ.0
ನೀಡಿರುವುದಾಗಿ	VM.v.any.any.any.	ನೀಡು.ಇರುವುದಾಗಿ
ಎಎನ್‌ಐ	UNK	ಎಎನ್‌ಐ.
ವರದಿ	NN.n.n.sg..d	ವರದಿ.0
ಮಾಡಿದೆ..	UNK	ಮಾಡಿದೆ...
.	SYM.punc....	..


59	QC.num....	59.
ರ	PSP.unk....	ರ.
ಹರೆಯದ	NN.n.n.sg..o	ಹರೆಯ.ಅ
ಪುಣಎ	UNK	ಪುಣಎ.
ಮೂಲದ	NN.n.n.sg..o	ಮೂಲ.ಅ
ಶಶಾಂಕ್‌	UNK	ಶಶಾಂಕ್‌.
ಮನೋಹರ್‌	UNK	ಮನೋಹರ್‌.
ಅವರು	PRP.n.f.pl.3.d	ಅವಳು.0
ಕಳೆದ	VM.v.any.any.any.	ಕಳೆ.ಅ
ಮೇ	NNP.unk....	ಮೇ.
ತಿಂಗಳಿನಲ್ಲಿ	NN.n.n.sg..o	ತಿಂಗಳು.ಅಲ್ಲಿ
2	QC.num....	2.
ವರ್ಷಗಳ	NN.n.n.pl..o	ವರ್ಷ.ಅ
ಅವಧಿಗೆ	NN.n.n.sg..o	ಅವಧಿ.ಇಗೆ
ಐಸಿಸಿ	VM.unk....	ಐಸಿಸಿ.
ಮುಖ್ಯಸ್ಥರಾಗಿ	RB.n.m.pl.3.o	ಮುಖ್ಯಸ್ಥ.ಆಗಿ
ಅವಿರೋಧವಾಗಿ	RB.unk....	ಅವಿರೋಧವಾಗಿ.
ಆಯ್ಕೆ	NN.n.n.sg..d	ಆಯ್ಕೆ.0
ಯಾಗಿದ್ದರು.	UNK	ಯಾಗಿದ್ದರು..
.	SYM.punc....	..


.	SYM.punc....	..
.	SYM.punc....	..


ಅಧಿಕಾರ	NN.n.n.sg..d	ಅಧಿಕಾರ.0
ಹಿಡಿದು	VM.v.any.any.any.	ಹಿಡಿ.ದು
ಅತ್ಯಲ್ಪ	JJ.n.n.sg..d	ಅತ್ಯಲ್ಪ.0
ಅವಧಿಯಲ್ಲಿ	NN.n.n.sg..o	ಅವಧಿ.ಅಲ್ಲಿ
ದೊಡ್ಡ	UNK	ದೊಡ್ಡ.
ಕ್ರಿಕೆಟ್‌	UNK	ಕ್ರಿಕೆಟ್‌.
ಬೋರ್ಡ್‌	UNK	ಬೋರ್ಡ್‌.
ಗಳೆಂದು	NN.unk....	ಗಳೆಂದು.
ಪರಿಗಣಿಸಲ್ಪಟ್ಟಿರುವ	VM.unk....	ಪರಿಗಣಿಸಲ್ಪಟ್ಟಿರುವಉನ್ಕ್.
ಆಸ್ಟ್ರೇಲಿಯಾ,	UNK	ಆಸ್ಟ್ರೇಲಿಯಾ,.
ಇಂಗ್ಲೆಂಡ್‌	UNK	ಇಂಗ್ಲೆಂಡ್‌.
ಮತ್ತು	CC.avy....	ಮತ್ತು.
ಬಿಸಿಸಿಐನ	UNK	ಬಿಸಿಸಿಐನ.
ಅಧಿಕಾರ	NN.n.n.sg..d	ಅಧಿಕಾರ.0
ವಿಕೇಂದ್ರಿಕರಣವನ್ನು	UNK	ವಿಕೇಂದ್ರಿಕರಣವನ್ನು.
ತಡೆದಿದ್ದರು.	UNK	ತಡೆದಿದ್ದರು..
.	SYM.punc....	..


ಇದು	PRP.n.n.sg..d	ಇದು.0
ಬಿಸಿಸಿಐನ	UNK	ಬಿಸಿಸಿಐನ.
ಕೆಂಗಣ್ಣಿಗೆ	NN.n.n.sg..o	ಕೆಂಗಣ್ಣು.ಇಗೆ
ಕಾರಣವಾಗಿ	RB.n.n.sg..o	ಕಾರಣ.ಆಗಿ
ಶಶಾಂಕ್‌	UNK	ಶಶಾಂಕ್‌.
ವಿರುದ್ಧ	JJ.avy....	ವಿರುದ್ಧ.
ಆಕ್ರೋಶವನ್ನೂ	NN.unk....	ಆಕ್ರೋಶವನ್ನೂ.
ಹೊರ	NST.avy....	ಹೊರ.
ಹಾಕಲಾಗಿತ್ತು.	UNK	ಹಾಕಲಾಗಿತ್ತು..
.	SYM.punc....	..


.	SYM.punc....	..
.	SYM.punc....	..


.	SYM.punc....	..


