ಕಾರವಾರ:	UNK	ಕಾರವಾರ:.
ಸೋಮವಾರ	NNP.n.n.sg..d	ಸೋಮವಾರ.0
ಬೆಳಗಿನ	NN.n.n.sg..o	ಬೆಳಗು.ಅ
ಜಾವ	NN.n.n.sg..d	ಜಾವ.0
ನಗರದ	NN.n.n.sg..o	ನಗರ.ಅ
ಲಂಡನ್‌	UNK	ಲಂಡನ್‌.
ಬ್ರಿಜ್‌	UNK	ಬ್ರಿಜ್‌.
ಸಮೀಪದ	NN.unk....	ಸಮೀಪದ.
ಕಾಡುಗುಡ್ಡದಿಂದ	UNK	ಕಾಡುಗುಡ್ಡದಿಂದ.
ನಾಯಿಗಳದಾಳಿಯಿಂದ	UNK	ನಾಯಿಗಳದಾಳಿಯಿಂದ.
ತಪ್ಪಿಸಿಕೊಳ್ಳಲು	UNK	ತಪ್ಪಿಸಿಕೊಳ್ಳಲು.
ಹೆಣ್ಣು	NN.n.n.sg..d	ಹೆಣ್ಣು.0
ಕಡವೆಯೊಂದು	UNK	ಕಡವೆಯೊಂದು.
ಸಮುದ್ರಕ್ಕೆ	NN.n.n.sg..o	ಸಮುದ್ರ.ಇಗೆ
ಜಿಗಿದು	VM.v.any.any.any.	ಜಿಗಿ.ದು
ಕೆಲ	JJ.avy....	ಕೆಲ.
ಸಮಯ	NN.n.n.sg..d	ಸಮಯ.0
ಕಡಲಲ್ಲಿ	NN.n.n.sg..o	ಕಡಲು.ಅಲ್ಲಿ
ಈಜಿತು.	UNK	ಈಜಿತು..
.	SYM.punc....	..


ಈ	DEM.avy....	ಈ.
ವೇಳೆ	NN.n.n.sg..d	ವೇಳೆ.0
ಮೀನುಗಾರರು	NN.n.m.pl.3.d	ಮೀನುಗಾರ.0
ದೋಣಿಯಲ್ಲಿ	NN.n.n.sg..o	ದೋಣಿ.ಅಲ್ಲಿ
ತೆರಳಿ	NN.v..pl.2.	ತೆರಳು.0
ಕಡವೆ	NN.n.n.sg..d	ಕಡವೆ.0
ಸಮುದ್ರದ	NN.n.n.sg..o	ಸಮುದ್ರ.ಅ
ಆಳಕ್ಕೆ	NN.n.n.sg..o	ಆಳ.ಇಗೆ
ಹೋಗದಂತೆ	VM.v.any.any.any.	ಹೋಗು.ಅದಂತೆ
ತಡೆದು	VM.v.any.any.any.	ತಡೆ.ದು
ರಕ್ಷಿಸಿ	VM.v..pl.2.	ರಕ್ಷಿಸು.0
ದಡಕ್ಕೆ	NN.n.n.sg..o	ದಡ.ಇಗೆ
ತಂದರು..	UNK	ತಂದರು...
.	SYM.punc....	..


ಫೋಟೋಗ್ರಾಫರ್‌	UNK	ಫೋಟೋಗ್ರಾಫರ್‌.
ಪಾಂಡುರಂಗ	NNP.unk....	ಪಾಂಡುರಂಗ.
ಹರಿಕಂತ್ರ	UNK	ಹರಿಕಂತ್ರ.
ಕಡವೆ	NN.n.n.sg..d	ಕಡವೆ.0
ರಕ್ಷಣೆಗಾಗಿ	NN.n.n.sg..o	ರಕ್ಷಣೆ.ಗಾಗಿ
ಸಮುದ್ರಕ್ಕೆ	NN.n.n.sg..o	ಸಮುದ್ರ.ಇಗೆ
ಜಿಗಿದಾಗ	VM.v.any.any.any.	ಜಿಗಿ.ಆಗ
ಕಡವೆ	NN.n.n.sg..d	ಕಡವೆ.0
ಕಾಲುತಾಗಿ	UNK	ಕಾಲುತಾಗಿ.
ಅವರ	PRP.n.f.pl.3.o	ಅವಳು.ಅ
ತಲೆಗೆ	NN.n.n.sg..o	ತಲೆ.ಇಗೆ
ಗಾಯವಾಗಿದ್ದು,	UNK	ಗಾಯವಾಗಿದ್ದು,.
ತಕ್ಷಣ	NN.avy....	ತಕ್ಷಣ.
ಸಿವಿಲ್‌	UNK	ಸಿವಿಲ್‌.
ಆಸ್ಪತ್ರೆಯಲ್ಲಿ	NN.n.n.sg..o	ಆಸ್ಪತ್ರೆ.ಅಲ್ಲಿ
ಚಿಕಿತ್ಸೆ	NN.n.n.sg..d	ಚಿಕಿತ್ಸೆ.0
ಕೊಡಿಸಲಾಯಿತು.	UNK	ಕೊಡಿಸಲಾಯಿತು..
.	SYM.punc....	..


ಅರಣ್ಯಾಧಿಕಾರಿಗಳು	NN.unk....	ಅರಣ್ಯಾಧಿಕಾರಿಗಳು.
ಸ್ಥಳಕ್ಕೆ	NN.n.n.sg..o	ಸ್ಥಳ.ಇಗೆ
ಧಾವಿಸಿ	VM.v..pl.2.	ಧಾವಿಸು.0
ಕಡವೆಗೆ	UNK	ಕಡವೆಗೆ.
ಪಶು	NN.n.n.sg..d	ಪಶು.0
ವೈದ್ಯಾಧಿಕಾರಿಗಳಿಂದ	UNK	ವೈದ್ಯಾಧಿಕಾರಿಗಳಿಂದ.
ಚಿಕಿತ್ಸೆ	NN.n.n.sg..d	ಚಿಕಿತ್ಸೆ.0
ಕೊಡಿಸಿದರು.	UNK	ಕೊಡಿಸಿದರು..
.	SYM.punc....	..


ಕಾರವಾರ	NNP.unk....	ಕಾರವಾರ.
ಡಿಎಫ್‌ಒ	UNK	ಡಿಎಫ್‌ಒ.
ಕಚೇರಿ	NN.n.n.sg..d	ಕಚೇರಿ.0
ಬಳಿಯ	NN.n.n.sg..o	ಬಳಿ.ಅ
ನರ್ಸರಿಗೆ	NN.unk....	ನರ್ಸರಿಗೆ.
ಕಡವೆಯನ್ನು	UNK	ಕಡವೆಯನ್ನು.
ಕೊಂಡೊಯ್ದು	UNK	ಕೊಂಡೊಯ್ದು.
ವಿಶ್ರಾಂತಿಗೆ	NN.n.n.sg..o	ವಿಶ್ರಾಂತಿ.ಇಗೆ
ಬಿಡಲಾಯಿತು.	UNK	ಬಿಡಲಾಯಿತು..
.	SYM.punc....	..


ನಂತರ	RB.avy....	ನಂತರ.
ಅಧಿಕಾರಿಗಳ	NN.n.m.pl.3.o	ಅಧಿಕಾರಿ.ಅ
ಸಮ್ಮುಖದಲ್ಲಿ	NN.n.n.sg..o	ಸಮ್ಮುಖ.ಅಲ್ಲಿ
ಕಾರವಾರ-ಗೋವಾ	UNK	ಕಾರವಾರ-ಗೋವಾ.
ನಡುವಿನ	NST.n.n.sg..o	ನಡುವು.ಅ
ಮೈಂಗಿಣಿ	UNK	ಮೈಂಗಿಣಿ.
ಅರಣ್ಯ	NN.n.n.sg..d	ಅರಣ್ಯ.0
ಪ್ರದೇಶದಲ್ಲಿ	NN.n.n.sg..o	ಪ್ರದೇಶ.ಅಲ್ಲಿ
ಹಳ್ಳದ	NN.n.n.sg..o	ಹಳ್ಳ.ಅ
ನೀರಿನ	NN.n.n.sg..o	ನೀರು.ಅ
ಸೌಲಭ್ಯವಿದ್ದು,	UNK	ಸೌಲಭ್ಯವಿದ್ದು,.
ಅಲ್ಲಿ	NST.avy....	ಅಲ್ಲಿ.
ಕಡವೆ	NN.n.n.sg..d	ಕಡವೆ.0
ಬಿಡಲು	VM.v.any.any.any.	ಬಿಡು.ಅಲು
ನಿರ್ಧರಿಸಲಾಯಿತು..	UNK	ನಿರ್ಧರಿಸಲಾಯಿತು...
.	SYM.punc....	..


.	SYM.punc....	..


