ಬೆಳಗಾವಿ:	UNK	ಬೆಳಗಾವಿ:.
ಜಿಲ್ಲೆಯ	NN.n.n.sg..o	ಜಿಲ್ಲೆ.ಅ
ಬೈಲಹೊಂಗಲ	NN.unk....	ಬೈಲಹೊಂಗಲ.
ತಾಲೂಕಿನ	NN.n.n.sg..o	ತಾಲೂಕು.ಅ
ಗಣಿಕೊಪ್ಪದಲ್ಲಿ	UNK	ಗಣಿಕೊಪ್ಪದಲ್ಲಿ.
ಸೋಮವಾರ	NNP.n.n.sg..d	ಸೋಮವಾರ.0
ತಡರಾತ್ರಿ	NN.unk....	ತಡರಾತ್ರಿ.
ಬಿಎಸ್‌ಎಫ್	UNK	ಬಿಎಸ್‌ಎಫ್.
ಯೋಧನೊಬ್ಬ	UNK	ಯೋಧನೊಬ್ಬ.
ವಿಷ	NN.n.n.sg..d	ವಿಷ.0
ಸೇವಿಸಿ	VM.v..pl.2.	ಸೇವಿಸು.0
ಆತ್ಮಹತ್ಯೆಗೆ	NN.unk....	ಆತ್ಮಹತ್ಯೆಗೆ.
ಶರಣಾದ	VM.unk....	ಶರಣಾದ.
ಘಟನೆ	NN.n.n.sg..d	ಘಟನೆ.0
ಸಂಭವಿಸಿದೆ.	UNK	ಸಂಭವಿಸಿದೆ..
.	SYM.punc....	..


.	SYM.punc....	..
.	SYM.punc....	..


ಬಸವರಾಜ್‌	UNK	ಬಸವರಾಜ್‌.
ಅಲಿಯಾಸ್‌	UNK	ಅಲಿಯಾಸ್‌.
ರಫೀಕ್‌	UNK	ರಫೀಕ್‌.
ಮುಲ್ಲಾ	NN.n.m.sg.3.o	ಮುಲ್ಲ.ಆ
 ಎಂಬ	UNK	 ಎಂಬ.
ಯೋಧ	NN.n.m.sg.3.d	ಯೋಧ.0
ಪತ್ನಿ	NN.n.f.sg.3.d	ಪತ್ನಿ.0
ಬಶೀರಾ	UNK	ಬಶೀರಾ.
ಮನೆಯ	NN.n.n.sg..o	ಮನೆ.ಅ
ಮುಂದೆಯೇ	NST.unk....	ಮುಂದೆಯೇ.
ವಿಷ	NN.n.n.sg..d	ವಿಷ.0
ಸೇವಿಸಿದ್ದು,	UNK	ಸೇವಿಸಿದ್ದು,.
ಚಿಂತಾಜನಕ	NN.unk....	ಚಿಂತಾಜನಕ.
ಸ್ಥಿತಿಯಲ್ಲಿದ್ದ	VM.unk....	ಸ್ಥಿತಿಯಲ್ಲಿದ್ದ.
ಅವರನ್ನು	PRP.n.f.pl.3.o	ಅವಳು.ಅನ್ನು
ಕೂಡಲೇ	RB.avy....	ಕೂಡಲೇ.
ಆಸ್ಪತ್ರೆಗೆ	NN.n.n.sg..o	ಆಸ್ಪತ್ರೆ.ಇಗೆ
ದಾಖಲಿಸಲಾಯಿತಾದೂ	UNK	ದಾಖಲಿಸಲಾಯಿತಾದೂ.
ಬದುಕಿಸಲು	VM.v.any.any.any.	ಬದುಕಿಸು.ಅಲು
ಸಾಧ್ಯವಾಗಲಿಲ್ಲ..	UNK	ಸಾಧ್ಯವಾಗಲಿಲ್ಲ...
.	SYM.punc....	..


ರಜೆ	NN.n.n.sg..d	ರಜೆ.0
ಹಿನ್ನಲೆಯಲ್ಲಿ	NN.n.n.sg..o	ಹಿನ್ನಲೆ.ಅಲ್ಲಿ
ಊರಿಗೆ	NN.n.n.sg..o	ಊರು.ಇಗೆ
ಬಂದಿದ್ದು,	UNK	ಬಂದಿದ್ದು,.
ಕೌಟುಂಬಿಕ	JJ.avy....	ಕೌಟುಂಬಿಕ.
ಕಲಹದಿಂದ	NN.n.n.sg..o	ಕಲಹ.ಇಂದ
ಆತ್ಮಹತ್ಯೆ	NN.unk....	ಆತ್ಮಹತ್ಯೆ.
ಮಾಡಿಕೊಂಡಿರುವ	UNK	ಮಾಡಿಕೊಂಡಿರುವ.
ಸಾಧ್ಯತೆಗಳಿವೆ	VM.unk....	ಸಾಧ್ಯತೆಗಳಿವೆ.
ಎನ್ನಲಾಗಿದೆ.	UNK	ಎನ್ನಲಾಗಿದೆ..
.	SYM.punc....	..


.	SYM.punc....	..
.	SYM.punc....	..


ಈ	DEM.avy....	ಈ.
ಬಗ್ಗೆ	NN.avy....	ಬಗ್ಗೆ.
ಪೊಲೀಸರು	NN.unk....	ಪೊಲೀಸರು.
ಪ್ರಕರಣ	NN.n.n.sg..d	ಪ್ರಕರಣ.0
ದಾಖಲಿಸಿಕೊಂಡಿದ್ದಾರೆ.	UNK	ದಾಖಲಿಸಿಕೊಂಡಿದ್ದಾರೆ..
.	SYM.punc....	..


.	SYM.punc....	..
.	SYM.punc....	..


.	SYM.punc....	..


