ಹೊಸದಿಲ್ಲಿ:	UNK	ಹೊಸದಿಲ್ಲಿ:.
ಕಳೆದ	VM.v.any.any.any.	ಕಳೆ.ಅ
11	QC.num....	11.
ದಿನಗಳಿಂದ	NN.n.n.pl..o	ದಿನ.ಇಂದ
ಇಲ್ಲಿನ	NST.unk....	ಇಲ್ಲಿನ.
ಜಂತರ್‌	UNK	ಜಂತರ್‌.
ಮಂತರ್‌ನಲ್ಲಿ	UNK	ಮಂತರ್‌ನಲ್ಲಿ.
ಪ್ರತಿಭಟಿಸುತ್ತಿರುವ	UNK	ಪ್ರತಿಭಟಿಸುತ್ತಿರುವ.
ತಮಿಳುನಾಡು	NNP.n.n.sg..d	ತಮಿಳುನಾಡು.0
ರೈತರಿಗೆ	NN.n.m.pl.3.o	ರೈತ.ಇಗೆ
ದಕ್ಷಿಣ	NST.n.n.sg..d	ದಕ್ಷಿಣ.0
ಭಾರತದ	NNP.n.n.sg..o	ಭಾರತ.ಅ
ಖ್ಯಾತ	JJ.unk....	ಖ್ಯಾತ.
ನಟ	NN.n.m.sg.3.d	ನಟ.0
ಪ್ರಕಾಶ್‌	UNK	ಪ್ರಕಾಶ್‌.
ರಾಜ್‌	UNK	ರಾಜ್‌.
ಬೆಂಬಲ	NN.n.n.sg..d	ಬೆಂಬಲ.0
ವ್ಯಕ್ತಪಡಿಸಿದ್ದಾರೆ.	UNK	ವ್ಯಕ್ತಪಡಿಸಿದ್ದಾರೆ..
.	SYM.punc....	..


ರಾಷ್ಟ್ರ	NN.n.n.sg..d	ರಾಷ್ಟ್ರ.0
ರಾಜಧಾನಿಗೆ	NN.n.n.sg..o	ರಾಜಧಾನಿ.ಇಗೆ
ತೆರಳಿ	NN.v..pl.2.	ತೆರಳು.0
ಪ್ರತಿಭಟನಾನಿರತ	UNK	ಪ್ರತಿಭಟನಾನಿರತ.
ಕೃಷಿಕರನ್ನು	NN.unk....	ಕೃಷಿಕರನ್ನು.
ಭೇಟಿಯಾದ	NNP.v.any.any.any.	ಭೇಟಿಯಾಗು.ಅ
ಪ್ರಕಾಶ್‌	UNK	ಪ್ರಕಾಶ್‌.
ರಾಜ್‌,	UNK	ರಾಜ್‌,.
""ದೇಶಕ್ಕೆ	UNK	""ದೇಶಕ್ಕೆ.
ಅನ್ನ	NN.n.n.sg..d	ಅನ್ನ.0
ನೀಡಲು	VM.v.any.any.any.	ನೀಡು.ಅಲು
ಇಡೀ	JJ.avy....	ಇಡೀ.
ಬದುಕನ್ನು	NN.n.n.sg..o	ಬದುಕು.ಅನ್ನು
ಕಷ್ಟದಲ್ಲೇ	UNK	ಕಷ್ಟದಲ್ಲೇ.
ಕಳೆಯುವ	VM.v.any.any.any.	ಕಳೆ.ವ
ಕೃಷಿಕರ	NN.unk....	ಕೃಷಿಕರ.
ನೋವನ್ನು	NN.n.n.sg..o	ನೋವು.ಅನ್ನು
ಯಾರೂ	PRP.avy....	ಯಾರೂ.
ಕೇಳುತ್ತಿಲ್ಲ.	UNK	ಕೇಳುತ್ತಿಲ್ಲ..
.	SYM.punc....	..


ಅವರ	PRP.n.f.pl.3.o	ಅವಳು.ಅ
ಬೆಳೆಗಳಿಗೆ	NN.n.n.pl..o	ಬೆಳೆ.ಇಗೆ
ಸೂಕ್ತ	JJ.n.n.sg..d	ಸೂಕ್ತ.0
ಬೆಲೆ	NN.n.n.sg..d	ಬೆಲೆ.0
ದೊರೆಯುತ್ತಿಲ್ಲ.	UNK	ದೊರೆಯುತ್ತಿಲ್ಲ..
.	SYM.punc....	..


ಹೀಗಾದರೆ	VM.unk....	ಹೀಗಾದರೆ.
ಅವರು	PRP.n.f.pl.3.d	ಅವಳು.0
ಬದುಕುವುದಾದರೂ	VM.v.any.any.any.	ಬದುಕು.ವುದಾದರೂ
ಹೇಗೆ?,''	UNK	ಹೇಗೆ?,''.
ಎಂದು	VM.v.any.any.any.	ಎನ್ನು.ದು
ಪ್ರಶ್ನಿಸಿದ್ದಾರೆ..	UNK	ಪ್ರಶ್ನಿಸಿದ್ದಾರೆ...
.	SYM.punc....	..


ತಮಿಳು	NN.unk....	ತಮಿಳು.
ನಟ	NN.n.m.sg.3.d	ನಟ.0
ವಿಶಾಲ್‌	UNK	ವಿಶಾಲ್‌.
ಹಾಗೂ	CC.avy....	ಹಾಗೂ.
ನಿರ್ದೇಶಕ	NN.n.m.sg.3.d	ನಿರ್ದೇಶಕ.0
ಪಾಂಡಿರಾಜ್‌	UNK	ಪಾಂಡಿರಾಜ್‌.
ಕೂಡ	RP.avy....	ಕೂಡ.
ರೈತರ	NN.n.m.pl.3.o	ರೈತ.ಅ
ಹೋರಾಟವನ್ನು	NN.n.n.sg..o	ಹೋರಾಟ.ಅನ್ನು
ಬೆಂಬಲಿಸಿದ್ದಾರೆ.	UNK	ಬೆಂಬಲಿಸಿದ್ದಾರೆ..
.	SYM.punc....	..


ಬರದಿಂದ	VM.n.n.sg..o	ಬರ.ಇಂದ
ತತ್ತರಿಸಿರುವ	VM.v.any.any.any.	ತತ್ತರಿಸು.ಇರುವ
ರಾಜ್ಯದ	NN.n.n.sg..o	ರಾಜ್ಯ.ಅ
ಕೃಷಿಕರಿಗೆ	NN.unk....	ಕೃಷಿಕರಿಗೆ.
ಸೂಕ್ತ	JJ.n.n.sg..d	ಸೂಕ್ತ.0
ಪರಿಹಾರ	NN.n.n.sg..d	ಪರಿಹಾರ.0
ನೀಡುವುದು	VM.v.n.sg.3.	ನೀಡು.ಉವ್
ಸೇರಿದಂತೆ	VM.v.any.any.any.	ಸೇರು.ಅಂತೆ
ಹಲವು	JJ.n.n.sg..d	ಹಲವು.0
ಬೇಡಿಕೆಗಳನ್ನು	NN.n.n.pl..o	ಬೇಡಿಕೆ.ಅನ್ನು
ಈಡೇರಿಸುವಂತೆ	VM.v.any.any.any.	ಈಡೇರಿಸು.ವಂತೆ
ಒತ್ತಾಯಿಸಿ	VM.v..pl.2.	ಒತ್ತಾಯಿಸು.0
ತಮಿಳುನಾಡು	NNP.n.n.sg..d	ತಮಿಳುನಾಡು.0
ರೈತರು	NN.n.m.pl.3.d	ರೈತ.0
ದಿಲ್ಲಿಯಲ್ಲಿ	NN.unk....	ದಿಲ್ಲಿಯಲ್ಲಿ.
ಪ್ರತಿಭಟಿಸುತ್ತಿದ್ದಾರೆ.	UNK	ಪ್ರತಿಭಟಿಸುತ್ತಿದ್ದಾರೆ..
.	SYM.punc....	..


ಕೇಂದ್ರ	NN.n.n.sg..d	ಕೇಂದ್ರ.0
ಸರಕಾರ	NN.n.n.sg..d	ಸರಕಾರ.0
ಈಗಾಗಲೇ	NST.avy....	ಈಗಾಗಲೇ.
1500	QC.num....	1500.
ಕೋಟಿ	QC.n.n.sg..d	ಕೋಟಿ.0
ರೂ.	UNK	ರೂ..
.	SYM.punc....	..


ಬರಪರಿಹಾರ	NN.unk....	ಬರಪರಿಹಾರ.
ಘೋಷಿಸಿದ್ದರೂ	UNK	ಘೋಷಿಸಿದ್ದರೂ.
ಅದು	PRP.n.n.sg..d	ಅದು.0
ಸಾಲುವುದಿಲ್ಲ	VM.v.any.any.any.	ಸಾಲು.ವುದಿಲ್ಲ
ಎಂಬುದು	PRP.n.n.sg..d	ಎಂಬುದು.0
ರೈತರ	NN.n.m.pl.3.o	ರೈತ.ಅ
ವಾದ..	UNK	ವಾದ...
.	SYM.punc....	..


.	SYM.punc....	..


