ಶೆಂಜನ್‌	UNK	ಶೆಂಜನ್‌.
(ಚೀನ):	UNK	(ಚೀನ):.
ಇಲ್ಲಿ	NST.avy....	ಇಲ್ಲಿ.
ನಡೆದ	VM.v.any.any.any.	ನಡೆ.ಅ
ಶೆಂಜನ್‌	UNK	ಶೆಂಜನ್‌.
ಮಾಸ್ಟರ್	NN.unk....	ಮಾಸ್ಟರ್.
ಚೆಸ್‌	UNK	ಚೆಸ್‌.
ಕೂಟದಲ್ಲಿ	NN.n.n.sg..o	ಕೂಟ.ಅಲ್ಲಿ
ಭಾರತದ	NNP.n.n.sg..o	ಭಾರತ.ಅ
ಗ್ರ್ಯಾನ್‌ಮಾಸ್ಟರ್‌	UNK	ಗ್ರ್ಯಾನ್‌ಮಾಸ್ಟರ್‌.
ಪಿ.ಹರಿಕೃಷ್ಣ	UNK	ಪಿ.ಹರಿಕೃಷ್ಣ.
ಸೋಲುಂಡಿದ್ದಾರೆ.	UNK	ಸೋಲುಂಡಿದ್ದಾರೆ..
.	SYM.punc....	..


ತಮ್ಮದೇ	PRP.unk....	ತಮ್ಮದೇ.
ದೇಶದ	NN.n.n.sg..o	ದೇಶ.ಅ
ಎದುರಾಳಿ	VM.n.m.sg.3.d	ಎದುರಾಳಿ.0
ಡಚ್‌	UNK	ಡಚ್‌.
ಗ್ರ್ಯಾನ್‌ಮಾಸ್ಟರ್‌	UNK	ಗ್ರ್ಯಾನ್‌ಮಾಸ್ಟರ್‌.
ಅನಿಶ್‌	UNK	ಅನಿಶ್‌.
ಗಿರಿ	NN.n.n.sg..d	ಗಿರಿ.0
ವಿರುದ್ಧದ	NN.unk....	ವಿರುದ್ಧದ.
ಪಂದ್ಯದಲ್ಲಿ	NN.n.n.sg..o	ಪಂದ್ಯ.ಅಲ್ಲಿ
ಅವರು	PRP.n.f.pl.3.d	ಅವಳು.0
ಸೋತರು..	UNK	ಸೋತರು...
.	SYM.punc....	..


ವಿಶ್ವ	NN.n.n.sg..d	ವಿಶ್ವ.0
14ನೇ	UNK	14ನೇ.
ಶ್ರೇಯಾಂಕ	NN.unk....	ಶ್ರೇಯಾಂಕ.
ಹೊಂದಿರುವ	VM.v.any.any.any.	ಹೊಂದು.ಇರುವ
ಹರಿಕೃಷ್ಣ	NN.unk....	ಹರಿಕೃಷ್ಣ.
ಮೇಲೆ	NST.n.n.sg..d	ಮೇಲೆ.0
ಕೂಟದ	NN.n.n.sg..o	ಕೂಟ.ಅ
ಆರಂಭಕ್ಕೂ	NN.n.n.sg..o	ಆರಂಭ.ಇಗೆ
ಮೊದಲು	NST.n.n.sg..d	ಮೊದಲು.0
ಸಾಕಷ್ಟು	QF.avy....	ಸಾಕಷ್ಟು.
ನಿರೀಕ್ಷೆಗಳು	NN.n.n.pl..d	ನಿರೀಕ್ಷೆ.0
ಇದ್ದವು.	UNK	ಇದ್ದವು..
.	SYM.punc....	..


ಹಲವು	JJ.n.n.sg..d	ಹಲವು.0
ತಪ್ಪುಗಳನ್ನು	NN.n.n.pl..o	ತಪ್ಪು.ಅನ್ನು
ಪ್ರಾಥಮಿಕ	JJ.unk....	ಪ್ರಾಥಮಿಕ.
ಹಂತದಲ್ಲೇ	NN.unk....	ಹಂತದಲ್ಲೇ.
ಎಸಗಿದ್ದರಿಂದ	UNK	ಎಸಗಿದ್ದರಿಂದ.
ಹರಿಕೃಷ್ಣ	NN.unk....	ಹರಿಕೃಷ್ಣ.
ಸೋಲು	NN.n.n.sg..d	ಸೋಲು.0
ಕಾಣಬೇಕಾಯಿತು.	UNK	ಕಾಣಬೇಕಾಯಿತು..
.	SYM.punc....	..


ಬಳಿಕ	RB.avy....	ಬಳಿಕ.
ನಡೆದ	VM.v.any.any.any.	ನಡೆ.ಅ
ಸುದ್ದಿಗೋಷ್ಠಿಯಲ್ಲಿ	NN.unk....	ಸುದ್ದಿಗೋಷ್ಠಿಯಲ್ಲಿ.
ಸ್ವತಃ	RB.avy....	ಸ್ವತಃ.
ಹರಿ	NN.n.m.sg.3.d	ಹರಿ.0
ಇದನ್ನು	PRP.n.n.sg..o	ಇದು.ಅನ್ನು
ಒಪ್ಪಿಕೊಂಡರು..	UNK	ಒಪ್ಪಿಕೊಂಡರು...
.	SYM.punc....	..


.	SYM.punc....	..


