ಧರ್ಮಶಾಲಾ:	UNK	ಧರ್ಮಶಾಲಾ:.
ಭಾರತದ	NNP.n.n.sg..o	ಭಾರತ.ಅ
ವಿರುದ್ಧ	JJ.avy....	ವಿರುದ್ಧ.
ಅಂತಿಮ	JJ.unk....	ಅಂತಿಮ.
ಟೆಸ್ಟ್‌	UNK	ಟೆಸ್ಟ್‌.
ಕ್ರಿಕೆಟ್‌	UNK	ಕ್ರಿಕೆಟ್‌.
ಪಂದ್ಯ	NN.n.n.sg..d	ಪಂದ್ಯ.0
ಆರಂಭವಾಗುವ	VM.unk....	ಆರಂಭವಾಗುವ.
ಒಂದು	QC.n.n.sg..d	ಒಂದು.0
ದಿನ	NN.n.n.sg..d	ದಿನ.0
ಮೊದಲು	NST.n.n.sg..d	ಮೊದಲು.0
ಅಂದರೆ	VM.v.any.any.any.	ಅನ್ನು.ಅರೆ
ಶುಕ್ರವಾರ	NNP.n.n.sg..d	ಶುಕ್ರವಾರ.0
ಆಸ್ಟ್ರೇಲಿಯಾ	NN.n.n.sg..d	ಆಸ್ಟ್ರೇಲಿಯಾ.0
ಕ್ರಿಕೆಟ್‌	UNK	ಕ್ರಿಕೆಟ್‌.
ತಂಡ	NN.n.n.sg..d	ತಂಡ.0
ಟಿಬೆಟಿಯನ್‌	UNK	ಟಿಬೆಟಿಯನ್‌.
ಧರ್ಮಗುರು	NN.unk....	ಧರ್ಮಗುರು.
ದಲೈಲಾಮಾರನ್ನು	UNK	ದಲೈಲಾಮಾರನ್ನು.
ಭೇಟಿಯಾಗಿ	RB.v..pl.2.	ಭೇಟಿಯಾಗು.0
ಆಶೀರ್ವಾದ	NN.n.n.sg..d	ಆಶೀರ್ವಾದ.0
ಪಡೆದಿದ್ದಾರೆ.	UNK	ಪಡೆದಿದ್ದಾರೆ..
.	SYM.punc....	..


.	SYM.punc....	..
.	SYM.punc....	..


ಈ	DEM.avy....	ಈ.
ವೇಳೆ	NN.n.n.sg..d	ವೇಳೆ.0
ಆಸೀಸ್‌	UNK	ಆಸೀಸ್‌.
ನಾಯಕ	NN.n.m.sg.3.d	ನಾಯಕ.0
ಸ್ಟೀವನ್‌	UNK	ಸ್ಟೀವನ್‌.
ಸ್ಮಿತ್‌	UNK	ಸ್ಮಿತ್‌.
ಪದ್ಧತಿಯಂತೆ	NN.n.n.sg..o	ಪದ್ಧತಿ.ಅಂತೆ
ದಲೈಲಾಮಾ	NN.unk....	ದಲೈಲಾಮಾ.
ಮೂಗಿಗೆ	NN.n.f.sg.3.o	ಮೂಗಿ.ಇಗೆ
ಮೂಗು	NN.n.n.sg..d	ಮೂಗು.0
ಉಜ್ಜಿದ್ದಾರೆ!	UNK	ಉಜ್ಜಿದ್ದಾರೆ!.
ಲಾಮಾ	NN.unk....	ಲಾಮಾ.
ಭೇಟಿ	NN.n.n.sg..d	ಭೇಟಿ.0
ಮಾಡಿದ	VM.v.any.any.any.	ಮಾಡು.ಅ
ನಂತರ	RB.avy....	ನಂತರ.
ಸ್ಟೀವ್‌	UNK	ಸ್ಟೀವ್‌.
ಬಹಳ	INTF.n.n.sg..d	ಬಹಳ.0
ಸಂತಸ	NN.n.n.sg..d	ಸಂತಸ.0
ವ್ಯಕ್ತಪಡಿಸಿದ್ದಾರೆ.	UNK	ವ್ಯಕ್ತಪಡಿಸಿದ್ದಾರೆ..
.	SYM.punc....	..


ಈ	DEM.avy....	ಈ.
ಟೆಸ್ಟ್‌	UNK	ಟೆಸ್ಟ್‌.
ಪಂದ್ಯದ	NN.n.n.sg..o	ಪಂದ್ಯ.ಅ
ಐದು	QC.n.n.sg..d	ಐದು.0
ದಿನಗಳಲ್ಲಿ	NN.n.n.pl..o	ದಿನ.ಅಲ್ಲಿ
ನಾನು	PRP.pn..sg.1.o	ನಾನು.0
ಆರಾಮಾಗಿ	RB.unk....	ಆರಾಮಾಗಿ.
ನಿದ್ರಿಸಲು	VM.v.any.any.any.	ನಿದ್ರಿಸು.ಅಲು
ಈ	DEM.avy....	ಈ.
ಭೇಟಿ	NN.n.n.sg..d	ಭೇಟಿ.0
ನೆರವಾಗಲಿದೆ..	UNK	ನೆರವಾಗಲಿದೆ...
.	SYM.punc....	..


ಅವರು	PRP.n.f.pl.3.d	ಅವಳು.0
ನಮಗೆ	PRP.pn..pl.1.o	ನಾನು.ಇಗೆ
ಶಾಂತವಾಗಿರುವುದು,	UNK	ಶಾಂತವಾಗಿರುವುದು,.
ಒತ್ತಡ	NN.n.n.sg..d	ಒತ್ತಡ.0
ನಿಭಾಯಿಸುವುದು	VM.v.n.sg.3.	ನಿಭಾಯಿಸು.ಉವ್
ಹೇಗೆಂದು	NN.unk....	ಹೇಗೆಂದು.
ಹೇಳಿಕೊಟ್ಟಿದ್ದಾರೆ.	UNK	ಹೇಳಿಕೊಟ್ಟಿದ್ದಾರೆ..
.	SYM.punc....	..


ಎಲ್ಲರನ್ನೂ	NN.avy....	ಎಲ್ಲರನ್ನೂ.
ಒಂದೇ	QC.avy....	ಒಂದೇ.
ಎಂಬ	PRP.unk....	ಎಂಬ.
ಭಾವದಿಂದ	NN.n.n.sg..o	ಭಾವ.ಇಂದ
ಕಾಣುವುದು,	UNK	ಕಾಣುವುದು,.
ಪ್ರೀತಿ,	UNK	ಪ್ರೀತಿ,.
ಕರುಣೆಯನ್ನೂ	NN.unk....	ಕರುಣೆಯನ್ನೂ.
ಅವರು	PRP.n.f.pl.3.d	ಅವಳು.0
ಕಲಿಸಿದರೆಂದು	UNK	ಕಲಿಸಿದರೆಂದು.
ಸ್ಟೀವ್‌	UNK	ಸ್ಟೀವ್‌.
ಹೇಳಿಕೊಂಡಿದ್ದಾರೆ.	UNK	ಹೇಳಿಕೊಂಡಿದ್ದಾರೆ..
.	SYM.punc....	..


.	SYM.punc....	..


