ಗುಂಡ್ಲುಪೇಟೆ	NNP.unk....	ಗುಂಡ್ಲುಪೇಟೆ.
:	SYM.punc....	:.
ಇಲ್ಲಿ	NST.avy....	ಇಲ್ಲಿ.
ಎಪ್ರಿಲ್‌	UNK	ಎಪ್ರಿಲ್‌.
9	QC.num....	9.
ರಂದು	NN.avy....	ರಂದು.
ನಡೆಯಲಿರುವ	VM.v.any.any.any.	ನಡೆ.ಅಲಿರುವ
ಉಪಚುನಾವಣಾ	UNK	ಉಪಚುನಾವಣಾ.
ಪ್ರಚಾರದ	NN.n.n.sg..o	ಪ್ರಚಾರ.ಅ
ಭರಾಟೆ	NN.n.n.sg..d	ಭರಾಟೆ.0
ಜೋರಾಗಿದ್ದು,	UNK	ಜೋರಾಗಿದ್ದು,.
ಈ	DEM.avy....	ಈ.
ವೇಳೆ	NN.n.n.sg..d	ವೇಳೆ.0
ಹಣ	NN.n.n.sg..d	ಹಣ.0
ಹಂಚಿಕೆಗೂ	NN.unk....	ಹಂಚಿಕೆಗೂ.
ಜೋರಾಗಿರುವುದು	UNK	ಜೋರಾಗಿರುವುದು.
ಕಂಡು	VM.v.any.any.any.	ಕಾಣು.ದು
ಬಂದಿದೆ.	UNK	ಬಂದಿದೆ..
.	SYM.punc....	..


ಶುಕ್ರವಾರ	NNP.n.n.sg..d	ಶುಕ್ರವಾರ.0
 ನಗರದ	UNK	 ನಗರದ.
ಖಾಸಗಿ	NN.unk....	ಖಾಸಗಿ.
ಹೊಟೇಲೊಂದರ	UNK	ಹೊಟೇಲೊಂದರ.
ಬಳಿ	NN.n.n.sg..d	ಬಳಿ.0
ಸರ್ಕಾರಿ	NN.unk....	ಸರ್ಕಾರಿ.
ಅಧಿಕಾರಿ	NN.n.m.sg.3.d	ಅಧಿಕಾರಿ.0
ಯೊಬ್ಬರ	UNK	ಯೊಬ್ಬರ.
ಕಾರಿನಲ್ಲಿ	NN.n.n.sg..o	ಕಾರು.ಅಲ್ಲಿ
20	QC.num....	20.
ಲಕ್ಷ	QC.n.n.sg..d	ಲಕ್ಷ.0
ರೂಪಾಯಿ	NN.n.n.sg..d	ರೂಪಾಯಿ.0
ಹಣವನ್ನು	NN.n.n.sg..o	ಹಣ.ಅನ್ನು
ಬಿಜೆಪಿ	NNP.unk....	ಬಿಜೆಪಿ.
ಕಾರ್ಯಕರ್ತರು	NN.n.m.pl.3.d	ಕಾರ್ಯಕರ್ತ.0
ಪತ್ತೆ	NN.n.n.sg..d	ಪತ್ತೆ.0
ಹಚ್ಚಿದ್ದಾರೆ.	UNK	ಹಚ್ಚಿದ್ದಾರೆ..
.	SYM.punc....	..


.	SYM.punc....	..
.	SYM.punc....	..


ವಾಯುವ್ಯ	NN.n.n.sg..d	ವಾಯುವ್ಯ.0
ಕರ್ನಾಟಕ	NNP.n.n.sg..d	ಕರ್ನಾಟಕ.0
ಸಾರಿಗೆ	NN.n.n.sg..d	ಸಾರಿಗೆ.0
ನಿಗಮದ	NN.n.n.sg..o	ನಿಗಮ.ಅ
 ನಿರ್ದೇಶಕ	UNK	 ನಿರ್ದೇಶಕ.
ಮನೋಜ್‌	UNK	ಮನೋಜ್‌.
ಕರ್ಜಗಿ	NN.unk....	ಕರ್ಜಗಿ.
ಅವರ	PRP.n.f.pl.3.o	ಅವಳು.ಅ
ಕಾರಿನಲ್ಲಿ	NN.n.n.sg..o	ಕಾರು.ಅಲ್ಲಿ
ಈ	DEM.avy....	ಈ.
ಹಣ	NN.n.n.sg..d	ಹಣ.0
ಪತ್ತೆಯಾಗಿದ್ದು,	UNK	ಪತ್ತೆಯಾಗಿದ್ದು,.
2	QC.num....	2.
ಸಾವಿರ	QC.unk....	ಸಾವಿರ.
ಮುಖಬೆಲೆಯ	NN.unk....	ಮುಖಬೆಲೆಯ.
10	QC.num....	10.
ಕಂತೆ	NN.n.n.sg..d	ಕಂತೆ.0
ನೋಟುಗಳು	NN.n.n.pl..d	ನೋಟು.0
ಇದ್ದವು	VM.v.n.pl.3.	ಇರು.ಇದ್
ಎಂದು	PRP.avy....	ಎಂದು.
ವರದಿಯಾಗಿದೆ.	UNK	ವರದಿಯಾಗಿದೆ..
.	SYM.punc....	..


.	SYM.punc....	..
.	SYM.punc....	..


ಸ್ಥಳಕ್ಕೆ	NN.n.n.sg..o	ಸ್ಥಳ.ಇಗೆ
ಗುಂಡ್ಲುಪೇಟೆ	NNP.unk....	ಗುಂಡ್ಲುಪೇಟೆ.
ಪೊಲೀಸರು	NNP.unk....	ಪೊಲೀಸರು.
ಭೇಟಿ	NN.n.n.sg..d	ಭೇಟಿ.0
ನೀಡಿ	VM.v..pl.2.	ನೀಡು.0
ಪರಿಶೀಲನೆ	NN.n.n.sg..d	ಪರಿಶೀಲನೆ.0
ನಡೆಸುತ್ತಿದ್ದು,ಕರ್ಜಗಿ	UNK	ನಡೆಸುತ್ತಿದ್ದು,ಕರ್ಜಗಿ.
ಅವರನ್ನೂ	PRP.unk....	ಅವರನ್ನೂ.
ವಶಕ್ಕೆ	NN.n.n.sg..o	ವಶ.ಇಗೆ
ಪಡೆದಿರುವ	VM.v.any.any.any.	ಪಡೆ.ಇರುವ
ಬಗ್ಗೆ	NN.avy....	ಬಗ್ಗೆ.
ತಿಳಿದು	VM.v.any.any.any.	ತಿಳಿ.ದು
ಬಂದಿದೆ.	UNK	ಬಂದಿದೆ..
.	SYM.punc....	..


ಹೆಚ್ಚಿನ	QF.n.n.sg..o	ಹೆಚ್ಚು.ಅ
ವಿವರ	NN.n.n.sg..d	ವಿವರ.0
ನಿರೀಕ್ಷಿಸಲಾಗುತ್ತಿದೆ.	UNK	ನಿರೀಕ್ಷಿಸಲಾಗುತ್ತಿದೆ..
.	SYM.punc....	..


.	SYM.punc....	..
.	SYM.punc....	..


.	SYM.punc....	..


